111111111111
1M 1     1M1
1111     1 1
1 1      1 1
1M1      1P1
111      1 1
1        1M1
1        111
1          1
111111111111
1M        M1
111111111111
