1111111111
1000000001
1000000001
1000000001
100000C001
10P0000001
1000000001
1000000001
1000000001
1111111111
