111111111111
1P000CCCCCE1
111111111111
