1111111
101P1M1
1010101
1010101
1M10101
1111111
