1111111111111
101C01C1111E1
101000C000001
1P0001C111101
1111111111111
