1111111111111111111
1000000000000000001
1000000000000000001
10000M0000000000001
1000000000000000001
1000000M00000000001
1000000000000000001
1000000000000000001
100000000P0000M0001
1000000000000000001
10000000M0000000001
10000000000000M0001
1000M00000000M00001
1000000000000000001
1000M00000000000001
100000000000M000001
1000000000000000001
1111111111111111111
