1111111111111111111111111
1CCCCCCCCCCC0000000000001
1CCCCCCCCCCC11000C000C001
1CCCCCCCCCCC1100000000001
1CCCCCCCCCCC11000000CC0C1
1CCCCCCCCCCC11000000CC0C1
1111111111111111111111111
