1111111111111111111111111
1PCCCCCCCCCC00000000001E1
1CCCCCCCCCCC11000C000C001
1CCCCCCCCCCC1100000000001
1CCCCCCCCCCC11000000CC0C1
1CCCCCCCCCCC11000000CC0C1
1111111111111111111111111
