1111111111111111
1CCCCCCCCCCCCCC1
1CP00000000000C1
1C011111111110C1
1C01M000000M10C1
1C010011100000C1
1C01001E100010C1
1C0100CCC00010C1
1C01M000000M10C1
1C011111111110C1
1C000000000000C1
1C111111110111C1
1C10CC000101M1C1
1C1MCC000101M1C1
1C111111110111C1
1C000000000000C1
1C111011111000C1
1C10101MM0100MC1
1C10101000100MC1
1C1M101000100MC1
1C11101111100MC1
1CCCCCCCCCCCCCC1
1111111111111111
