11111111
1 1    1
1 1    1
1M1    1
1 1    1
1 1    1
1P1    1
11111111
