1111111
1CCC1E1
1MCCCM1
10CCC01
10CCCM1
1P1CCC1
1111111
