1111111111111111
1M0C0MC00C0MC0C1
1C0110111M111M11
10C11CCCCCCCCCC1
1CM1C11011110111
1MC1C010CCCCCCC1
1C01CM10MCMMMCM1
10C1M010CCCCC1C1
1CM1MC1C0MC011M1
10C1M001111111M1
1C110C0CC1CCCCC1
1CM10CMMC111MMC1
1CM10CCCCC0CCC11
10C1M011C1CC1111
1CC111C1C1CCCCC1
1100C1M0C100CCM1
1CM111M0C111M0C1
10C1CCM0CCCM1001
1C0111111CCC1CM1
1C0MCCM11CCM1CC1
1M0CCC011111M0C1
11MCC00P11ECCM11
1111111111111111
