1111111111
1000000001
1000000001
1000P00000001
100000C000001
1000000001
1000000001
1000E00001
1000000001
1111111111
