1111001111
1000000001
1000000001
1000P00001
100000C001
1000000001
1000000001
1000E00001
1000000001
1111111111
